muw_unboosted	misc=unweighted_matches:true$boosting_method:none
mw_unboosted	misc=unweighted_matches:false$boosting_method:none
v1_linear0	misc=unweighted_matches:false$inner_boost:true$boosting_method:linear$linear_levels:42$linear_start:0
v1_linear5	misc=unweighted_matches:false$inner_boost:true$boosting_method:linear$linear_levels:42$linear_start:5
v1_linear10	misc=unweighted_matches:false$inner_boost:true$boosting_method:linear$linear_levels:42$linear_start:10
v1_linear15	misc=unweighted_matches:false$inner_boost:true$boosting_method:linear$linear_levels:42$linear_start:15
v1_linear20	misc=unweighted_matches:false$inner_boost:true$boosting_method:linear$linear_levels:42$linear_start:20
v1_linear25	misc=unweighted_matches:false$inner_boost:true$boosting_method:linear$linear_levels:42$linear_start:25
v1_linear30	misc=unweighted_matches:false$inner_boost:true$boosting_method:linear$linear_levels:42$linear_start:30
v1_linear35	misc=unweighted_matches:false$inner_boost:true$boosting_method:linear$linear_levels:42$linear_start:35
v1_mult5	misc=unweighted_matches:false$inner_boost:true$boosting_method:mult$mult_factor:5
v1_mult10	misc=unweighted_matches:false$inner_boost:true$boosting_method:mult$mult_factor:10
v1_mult15	misc=unweighted_matches:false$inner_boost:true$boosting_method:mult$mult_factor:15
v1_mult20	misc=unweighted_matches:false$inner_boost:true$boosting_method:mult$mult_factor:20
v1_mult50	misc=unweighted_matches:false$inner_boost:true$boosting_method:mult$mult_factor:50
v1_mult100	misc=unweighted_matches:false$inner_boost:true$boosting_method:mult$mult_factor:100
v1_mult250	misc=unweighted_matches:false$inner_boost:true$boosting_method:mult$mult_factor:250
v1_mult500	misc=unweighted_matches:false$inner_boost:true$boosting_method:mult$mult_factor:500
v1_mult1000	misc=unweighted_matches:false$inner_boost:true$boosting_method:mult$mult_factor:1000
v1_root2	misc=unweighted_matches:false$inner_boost:true$boosting_method:root$root_degree:2
v1_root3	misc=unweighted_matches:false$inner_boost:true$boosting_method:root$root_degree:3
v1_root4	misc=unweighted_matches:false$inner_boost:true$boosting_method:root$root_degree:4
v1_root5	misc=unweighted_matches:false$inner_boost:true$boosting_method:root$root_degree:5
v1_root6	misc=unweighted_matches:false$inner_boost:true$boosting_method:root$root_degree:6
v1_root7	misc=unweighted_matches:false$inner_boost:true$boosting_method:root$root_degree:7
v1_root8	misc=unweighted_matches:false$inner_boost:true$boosting_method:root$root_degree:8
v1_root9	misc=unweighted_matches:false$inner_boost:true$boosting_method:root$root_degree:9
v1_root10	misc=unweighted_matches:false$inner_boost:true$boosting_method:root$root_degree:10
v1_rootshift2	misc=unweighted_matches:false$inner_boost:true$boosting_method:root$root_shift:full$root_degree:2
v1_rootshift3	misc=unweighted_matches:false$inner_boost:true$boosting_method:root$root_shift:full$root_degree:3
v1_rootshift4	misc=unweighted_matches:false$inner_boost:true$boosting_method:root$root_shift:full$root_degree:4
v1_rootshift5	misc=unweighted_matches:false$inner_boost:true$boosting_method:root$root_shift:full$root_degree:5
v1_rootshift6	misc=unweighted_matches:false$inner_boost:true$boosting_method:root$root_shift:full$root_degree:6
v1_rootshift7	misc=unweighted_matches:false$inner_boost:true$boosting_method:root$root_shift:full$root_degree:7
v1_rootshift8	misc=unweighted_matches:false$inner_boost:true$boosting_method:root$root_shift:full$root_degree:8
v1_rootshift9	misc=unweighted_matches:false$inner_boost:true$boosting_method:root$root_shift:full$root_degree:9
v1_rootshift10	misc=unweighted_matches:false$inner_boost:true$boosting_method:root$root_shift:full$root_degree:10
v2_linear0	misc=unweighted_matches:true$inner_boost:true$boosting_method:linear$linear_levels:42$linear_start:0
v2_linear5	misc=unweighted_matches:true$inner_boost:true$boosting_method:linear$linear_levels:42$linear_start:5
v2_linear10	misc=unweighted_matches:true$inner_boost:true$boosting_method:linear$linear_levels:42$linear_start:10
v2_linear15	misc=unweighted_matches:true$inner_boost:true$boosting_method:linear$linear_levels:42$linear_start:15
v2_linear20	misc=unweighted_matches:true$inner_boost:true$boosting_method:linear$linear_levels:42$linear_start:20
v2_linear25	misc=unweighted_matches:true$inner_boost:true$boosting_method:linear$linear_levels:42$linear_start:25
v2_linear30	misc=unweighted_matches:true$inner_boost:true$boosting_method:linear$linear_levels:42$linear_start:30
v2_linear35	misc=unweighted_matches:true$inner_boost:true$boosting_method:linear$linear_levels:42$linear_start:35
v2_mult5	misc=unweighted_matches:true$inner_boost:true$boosting_method:mult$mult_factor:5
v2_mult10	misc=unweighted_matches:true$inner_boost:true$boosting_method:mult$mult_factor:10
v2_mult15	misc=unweighted_matches:true$inner_boost:true$boosting_method:mult$mult_factor:15
v2_mult20	misc=unweighted_matches:true$inner_boost:true$boosting_method:mult$mult_factor:20
v2_mult50	misc=unweighted_matches:true$inner_boost:true$boosting_method:mult$mult_factor:50
v2_mult100	misc=unweighted_matches:true$inner_boost:true$boosting_method:mult$mult_factor:100
v2_mult250	misc=unweighted_matches:true$inner_boost:true$boosting_method:mult$mult_factor:250
v2_mult500	misc=unweighted_matches:true$inner_boost:true$boosting_method:mult$mult_factor:500
v2_mult1000	misc=unweighted_matches:true$inner_boost:true$boosting_method:mult$mult_factor:1000
v2_root2	misc=unweighted_matches:true$inner_boost:true$boosting_method:root$root_degree:2
v2_root3	misc=unweighted_matches:true$inner_boost:true$boosting_method:root$root_degree:3
v2_root4	misc=unweighted_matches:true$inner_boost:true$boosting_method:root$root_degree:4
v2_root5	misc=unweighted_matches:true$inner_boost:true$boosting_method:root$root_degree:5
v2_root6	misc=unweighted_matches:true$inner_boost:true$boosting_method:root$root_degree:6
v2_root7	misc=unweighted_matches:true$inner_boost:true$boosting_method:root$root_degree:7
v2_root8	misc=unweighted_matches:true$inner_boost:true$boosting_method:root$root_degree:8
v2_root9	misc=unweighted_matches:true$inner_boost:true$boosting_method:root$root_degree:9
v2_root10	misc=unweighted_matches:true$inner_boost:true$boosting_method:root$root_degree:10
v2_rootshift2	misc=unweighted_matches:true$inner_boost:true$boosting_method:root$root_shift:full$root_degree:2
v2_rootshift3	misc=unweighted_matches:true$inner_boost:true$boosting_method:root$root_shift:full$root_degree:3
v2_rootshift4	misc=unweighted_matches:true$inner_boost:true$boosting_method:root$root_shift:full$root_degree:4
v2_rootshift5	misc=unweighted_matches:true$inner_boost:true$boosting_method:root$root_shift:full$root_degree:5
v2_rootshift6	misc=unweighted_matches:true$inner_boost:true$boosting_method:root$root_shift:full$root_degree:6
v2_rootshift7	misc=unweighted_matches:true$inner_boost:true$boosting_method:root$root_shift:full$root_degree:7
v2_rootshift8	misc=unweighted_matches:true$inner_boost:true$boosting_method:root$root_shift:full$root_degree:8
v2_rootshift9	misc=unweighted_matches:true$inner_boost:true$boosting_method:root$root_shift:full$root_degree:9
v2_rootshift10	misc=unweighted_matches:true$inner_boost:true$boosting_method:root$root_shift:full$root_degree:10
v3_linear0	misc=unweighted_matches:false$inner_boost:false$boosting_method:linear$linear_levels:42$linear_start:0
v3_linear5	misc=unweighted_matches:false$inner_boost:false$boosting_method:linear$linear_levels:42$linear_start:5
v3_linear10	misc=unweighted_matches:false$inner_boost:false$boosting_method:linear$linear_levels:42$linear_start:10
v3_linear15	misc=unweighted_matches:false$inner_boost:false$boosting_method:linear$linear_levels:42$linear_start:15
v3_linear20	misc=unweighted_matches:false$inner_boost:false$boosting_method:linear$linear_levels:42$linear_start:20
v3_linear25	misc=unweighted_matches:false$inner_boost:false$boosting_method:linear$linear_levels:42$linear_start:25
v3_linear30	misc=unweighted_matches:false$inner_boost:false$boosting_method:linear$linear_levels:42$linear_start:30
v3_linear35	misc=unweighted_matches:false$inner_boost:false$boosting_method:linear$linear_levels:42$linear_start:35
v3_mult5	misc=unweighted_matches:false$inner_boost:false$boosting_method:mult$mult_factor:5
v3_mult10	misc=unweighted_matches:false$inner_boost:false$boosting_method:mult$mult_factor:10
v3_mult15	misc=unweighted_matches:false$inner_boost:false$boosting_method:mult$mult_factor:15
v3_mult20	misc=unweighted_matches:false$inner_boost:false$boosting_method:mult$mult_factor:20
v3_mult50	misc=unweighted_matches:false$inner_boost:false$boosting_method:mult$mult_factor:50
v3_mult100	misc=unweighted_matches:false$inner_boost:false$boosting_method:mult$mult_factor:100
v3_mult250	misc=unweighted_matches:false$inner_boost:false$boosting_method:mult$mult_factor:250
v3_mult500	misc=unweighted_matches:false$inner_boost:false$boosting_method:mult$mult_factor:500
v3_mult1000	misc=unweighted_matches:false$inner_boost:false$boosting_method:mult$mult_factor:1000
v3_root2	misc=unweighted_matches:false$inner_boost:false$boosting_method:root$root_degree:2
v3_root3	misc=unweighted_matches:false$inner_boost:false$boosting_method:root$root_degree:3
v3_root4	misc=unweighted_matches:false$inner_boost:false$boosting_method:root$root_degree:4
v3_root5	misc=unweighted_matches:false$inner_boost:false$boosting_method:root$root_degree:5
v3_root6	misc=unweighted_matches:false$inner_boost:false$boosting_method:root$root_degree:6
v3_root7	misc=unweighted_matches:false$inner_boost:false$boosting_method:root$root_degree:7
v3_root8	misc=unweighted_matches:false$inner_boost:false$boosting_method:root$root_degree:8
v3_root9	misc=unweighted_matches:false$inner_boost:false$boosting_method:root$root_degree:9
v3_root10	misc=unweighted_matches:false$inner_boost:false$boosting_method:root$root_degree:10
v3_rootshift2	misc=unweighted_matches:false$inner_boost:false$boosting_method:root$root_shift:full$root_degree:2
v3_rootshift3	misc=unweighted_matches:false$inner_boost:false$boosting_method:root$root_shift:full$root_degree:3
v3_rootshift4	misc=unweighted_matches:false$inner_boost:false$boosting_method:root$root_shift:full$root_degree:4
v3_rootshift5	misc=unweighted_matches:false$inner_boost:false$boosting_method:root$root_shift:full$root_degree:5
v3_rootshift6	misc=unweighted_matches:false$inner_boost:false$boosting_method:root$root_shift:full$root_degree:6
v3_rootshift7	misc=unweighted_matches:false$inner_boost:false$boosting_method:root$root_shift:full$root_degree:7
v3_rootshift8	misc=unweighted_matches:false$inner_boost:false$boosting_method:root$root_shift:full$root_degree:8
v3_rootshift9	misc=unweighted_matches:false$inner_boost:false$boosting_method:root$root_shift:full$root_degree:9
v3_rootshift10	misc=unweighted_matches:false$inner_boost:false$boosting_method:root$root_shift:full$root_degree:10
v4_linear0	misc=unweighted_matches:true$inner_boost:false$boosting_method:linear$linear_levels:42$linear_start:0
v4_linear5	misc=unweighted_matches:true$inner_boost:false$boosting_method:linear$linear_levels:42$linear_start:5
v4_linear10	misc=unweighted_matches:true$inner_boost:false$boosting_method:linear$linear_levels:42$linear_start:10
v4_linear15	misc=unweighted_matches:true$inner_boost:false$boosting_method:linear$linear_levels:42$linear_start:15
v4_linear20	misc=unweighted_matches:true$inner_boost:false$boosting_method:linear$linear_levels:42$linear_start:20
v4_linear25	misc=unweighted_matches:true$inner_boost:false$boosting_method:linear$linear_levels:42$linear_start:25
v4_linear30	misc=unweighted_matches:true$inner_boost:false$boosting_method:linear$linear_levels:42$linear_start:30
v4_linear35	misc=unweighted_matches:true$inner_boost:false$boosting_method:linear$linear_levels:42$linear_start:35
v4_mult5	misc=unweighted_matches:true$inner_boost:false$boosting_method:mult$mult_factor:5
v4_mult10	misc=unweighted_matches:true$inner_boost:false$boosting_method:mult$mult_factor:10
v4_mult15	misc=unweighted_matches:true$inner_boost:false$boosting_method:mult$mult_factor:15
v4_mult20	misc=unweighted_matches:true$inner_boost:false$boosting_method:mult$mult_factor:20
v4_mult50	misc=unweighted_matches:true$inner_boost:false$boosting_method:mult$mult_factor:50
v4_mult100	misc=unweighted_matches:true$inner_boost:false$boosting_method:mult$mult_factor:100
v4_mult250	misc=unweighted_matches:true$inner_boost:false$boosting_method:mult$mult_factor:250
v4_mult500	misc=unweighted_matches:true$inner_boost:false$boosting_method:mult$mult_factor:500
v4_mult1000	misc=unweighted_matches:true$inner_boost:false$boosting_method:mult$mult_factor:1000
v4_root2	misc=unweighted_matches:true$inner_boost:false$boosting_method:root$root_degree:2
v4_root3	misc=unweighted_matches:true$inner_boost:false$boosting_method:root$root_degree:3
v4_root4	misc=unweighted_matches:true$inner_boost:false$boosting_method:root$root_degree:4
v4_root5	misc=unweighted_matches:true$inner_boost:false$boosting_method:root$root_degree:5
v4_root6	misc=unweighted_matches:true$inner_boost:false$boosting_method:root$root_degree:6
v4_root7	misc=unweighted_matches:true$inner_boost:false$boosting_method:root$root_degree:7
v4_root8	misc=unweighted_matches:true$inner_boost:false$boosting_method:root$root_degree:8
v4_root9	misc=unweighted_matches:true$inner_boost:false$boosting_method:root$root_degree:9
v4_root10	misc=unweighted_matches:true$inner_boost:false$boosting_method:root$root_degree:10
v4_rootshift2	misc=unweighted_matches:true$inner_boost:false$boosting_method:root$root_shift:full$root_degree:2
v4_rootshift3	misc=unweighted_matches:true$inner_boost:false$boosting_method:root$root_shift:full$root_degree:3
v4_rootshift4	misc=unweighted_matches:true$inner_boost:false$boosting_method:root$root_shift:full$root_degree:4
v4_rootshift5	misc=unweighted_matches:true$inner_boost:false$boosting_method:root$root_shift:full$root_degree:5
v4_rootshift6	misc=unweighted_matches:true$inner_boost:false$boosting_method:root$root_shift:full$root_degree:6
v4_rootshift7	misc=unweighted_matches:true$inner_boost:false$boosting_method:root$root_shift:full$root_degree:7
v4_rootshift8	misc=unweighted_matches:true$inner_boost:false$boosting_method:root$root_shift:full$root_degree:8
v4_rootshift9	misc=unweighted_matches:true$inner_boost:false$boosting_method:root$root_shift:full$root_degree:9
v4_rootshift10	misc=unweighted_matches:true$inner_boost:false$boosting_method:root$root_shift:full$root_degree:10
